0000000000000000000000000000000000000000
0                                      0
0                                      0
0                                      0
0                                      0
0                                      0
0              e                       0
0              0  0                    0
0              0     g     0           0
0              0     0          0      0
0   e          0                       0
0   0    0     0                    hhh0
0   0       00   e         e        h  0
0   0       00  000        0        h p0
00000       00       g   0        000000
00000       00 e e 000        0   000000
0llllllllllll0000000lllllllllllllllllll0
0llllllllllllllllllllllllllllllllllllll0
0llllllllllllllllllllllllllllllllllllll0
0000000000000000000000000000000000000000