000000000000000000000000000000000000000000000000000000000000
0                   0l0 p 0l0                              0
0 gg e              0l0hhh0l0                              0
000000 0                   l0                              0
0       0       0 0000000000000                            0
0          0 e            0              e                 0
0            0            g              0                 0
0               0         g       e      0   0             0
0                   0     0   0   0    0 0lll0g            0
0                     0   0              000000            0
0                         0                        0       0
0                         0              e                 0
0                                        0             e   0
0   e           e   0     0    e      s     0  e       0   0
00000   0   0   s       s 0s   s   s           0          g0
00000                     0                        0    0000
0llllllllllllllllllllllllllllllllllllllllllllllllllllllllll0
0llllllllllllllllllllllllllllllllllllllllllllllllllllllllll0
0llllllllllllllllllllllllllllllllllllllllllllllllllllllllll0
000000000000000000000000000000000000000000000000000000000000